╔════════════════════╦═══════╗
║☺•••••••••••••••••••║•••••••║
╠═════╗•╔═══╗•╔═════•║•════╗•║
║•••••║•║   ║•║•••••☻••••••║•║
║•════╝•╚═══╝•╚═════•╚═════╝•║
║•••••••••••☻••••••••••••••••║
╚════════════════════════════╝